20 20
**-****-**-***-*-*$*
**-*--*-*-***-**-*--
-**-*--**-**---***-*
*****------**-***-**
*****#*----**-*-*-**
*--*****--*---****-*
--*--***-*--*-**--*-
-**---*---*---*-****
-*-**-*-**-*---**--*
**-******----*-*-**-
-**-**-*-**---*-*-**
-*----***--*-***-**-
*****-**-*****-***--
*-****---*--*------*
---*---*****-***-***
--*--****-**--*--*--
***----*----**-**--*
*-*----******--*-***
*-----*-*---**---*-*
----***-***-*---***-
