37 37
-------------------------------------
-*******-*-*-***********-***-*****-*-
-*-------*-*---*-*---*---*-------*-*-
-*******-*******-*-*****-*****-*-***-
-----*-----*---*-*-*-*---*-----*-*---
-***-*-*-*-***-*-*-*-***-*-***-*-***-
-*---*-*-*-*---*-----*---*-*---*---*-
-*******-*****-***-***-*****-*-*-***-
---*---------*-------*---*---*-*-*-*-
-*************-*******-*-***-*****-*-
-*-*-----*-*---*-*-*---*-*---*---*-*-
-*-*-*****-*-*-*-*-*****-***-*-*-*-*-
-*-*-*-------*-*---------*---*-*---*-
-*-*-*-*****-***-*****-*****-***-***-
---*---*-*-----*-----*---*---*-----*-
-*****-*-*-*****-*-*****-*-***-*-*-*-
-*-*-*-*-*---*---*---*---*-*-*-*-*-*-
-*-*-*-*-*****************-*-*-*****-
---*-------*-*-*-----*---*-*---*-----
-*******-*-*-*-*****-***-*****-*-***-
-----*-*-*---------*-----------*-*---
-***-*-***********-*-*****-***-*-***-
-*---*-----*---------*-----*-*-*---*-
-*-***-******-********-*****-*******-
-*-*-*-----*---*-*-*-*-*-------------
-*-*-***-*****-*-*-*-*******-***-*-*-
-*-*---*---*-*-*-*---------*---*-*-*-
-*-***-*-***-*-*-***-*-***-*-*-*****-
-*---*---*-----*---*-*-*-----*-*-----
-*******-***-*****-*-*****-***-*-***-
---*-*-----*-----*---*---*-*---*-*---
-*-*-*-*-*-*-*-*****-*-***-*-***-*-*-
-*-*---*-*-*-*-*---------*-*-*-*-*-*-
-***-***-***-*****************-*****-
-*-*-*-*---*---*-------*---*---*---*-
-#-*-*-*******-***-*******-***-*-**$-
-------------------------------------
