50 50
****************-****--********-****-***-*********
***-*********************--************-*--****--*
--*****-***-**************--**------*********--***
********-*******-*-********-******---****-******--
*****-****-*-**-*--*****-**-**********--**********
*****-**-***-********-************-*--****-*****-*
-***--*****-******-***--********-***-**-**********
**--*******-*****--*******--**************--*-****
**********-***-***--*****-**************-*********
********-***--********-**********-**********-*****
*********-*************--**-******--********-$*-**
************-******-*-*****--****-************-*-*
***--**-*-***********-********-*********-******-**
**-****---**-************--*******--***-****-*****
********--*-*-***-**********-********--******-**-*
**-**---**********-********-*******-*-*****-***-**
-***************-*********************-**-***-****
-****-*-**-*******-***-**-*********-*-*-******-*-*
**-***-*-*-*****-*--*****-****-***-**--***---**-**
-***--***--*---***********-**-***********-*--**-**
********-*****-*****-****-**-*********************
********--*******--***-**********-****************
****************-*-****-******-*******************
*-*********-***--***-*******-*****-******-*****-*-
******-****************-************-************-
-************-***--****-****-*******-****--*-**--*
**-****-******#--****-******--**********--**-*****
**-********--***********-*--**-**-**-*-***********
*****----***-****-*-*****-*********************-**
*****-********-*****-**********-*--*****-*********
***-**-********-*******-******************-*******
*-***-*****--*-*****-***--*-**********-*-*****---*
***-*--******-*-*************--**-**-*****-******-
-****-**-**-*-******-***-*-*-***-**-******-*******
-**-******---*******----***-*********--***********
******-**-*-***--********-*--**-*-*********-****-*
*-***--***********-*******************-********-**
*****-***-*-**-*****-*************-*****-*****-*-*
**-**-*-**-********-*********-*********---**-*****
****-*-**-****-***-****-**---*******---**-*---****
***-*-*-*****************-**-*---*--*--***--******
***********-**-**-********--*******--******-*-****
-******-****-**********--*-****-****-***-*********
*--****-**-*-*******--*********--*--***-***-**-***
*****-*-****--********-**-************************
***********-*****-*******-*********-********--****
*-******-*--*-*******-***-**-*-*********-******-*-
***************-*****-**-******--*********-*******
*-****-*******-*-*************-*-***-*-**-****-***
*******-****-**-***--*******-************-*-*****-
