12 12
------------
-#*********-
-*------*---
-*-********-
-*-*------*-
-*-*-******-
-***--*---*-
-*-****-*---
-*--*-*****-
-*-**-----*-
-***--****$-
------------