20 20
*******-********-*$*
**-*--***-***-**-*--
-**-*--**-**---***-*
****-------**-***-**
****-#*----**-*-*-**
*-**--**--*---****-*
--*--***-*--*-**--**
-**---*---*---*-****
-*-**-*-**-*---**--*
**-******----*-*-***
-**-**-*-**---*-*-**
-*----***--*-***-**-
********-*****-***--
*-****-*-*--**-----*
--**---*****-***-***
--*--****-**--**-*--
***----*----**-**--*
*-*----******--*****
*-----*-*---**---*-*
----***-***-*---***-

